4,4,4,4,4,4,4,4,4,4
4,0,4,2,2,2,2,2,2,4
4,2,4,2,4,4,4,4,2,4
4,2,4,3,4,1,2,4,3,4
4,2,4,3,4,4,2,4,2,4
4,2,4,2,4,4,2,4,2,4
4,2,4,2,2,2,2,4,2,4
4,3,4,4,4,4,4,4,2,4
4,2,2,2,2,2,2,2,2,4
4,4,4,4,4,4,4,4,4,4